BBBBBBBBBBBBBBBBBBBBBBBBBBBBBBBBBBBBBBBBBBBBBBBB
BBBBBBBBBBBBBBBBBBBBBBBBBBBBBBBBBBBBBBBBBBBBBBBB
BBBBBBBBBBBBBBBBBBBBBBBBBBBBBBBBBBBBBBBBBBBBBBBB
BBBBBBBBBBBBBBBBBBBBBBBBBBBBBBBBBBBBBBBBBBBBBBBB
BBBBBBBBBB                             BBBBBBBBB
BBBBBBBBBB                             BBBBBBBBB
BBBBBBBBBB                   E         BBBBBBBBB
BBBBBBBBBB                  BBB        BBBBBBBBB
BBBBBBBBBB               BBB          FBBBBBBBBB
BBBBBBBBBB        BB           SSSSSSFFBBBBBBBBB
BBBBBBBBBB                  BBBBBBBBBBBBBBBBBBBB
BBBBBBBBBB  BBB             CCCCCCCCCLCBBBBBBBBB
BBBBBBBBBB     P            SSSSSSSSSSSBBBBBBBBB
BBBBBBBBBBBBBBBBBBBBBBBBBBBBBBBBBBBBBBBBBBBBBBBB
BBBBBBBBBBBBBBBBBBBBBBBBBBBBBBBBBBBBBBBBBBBBBBBB
BBBBBBBBBBBBBBBBBBBBBBBBBBBBBBBBBBBBBBBBBBBBBBBB
BBBBBBBBBBBBBBBBBBBBBBBBBBBBBBBBBBBBBBBBBBBBBBBB
BBBBBBBBBBBBBBBBBBBBBBBBBBBBBBBBBBBBBBBBBBBBBBBB