BBBBBBBBBBBBBBBBBBBBBBBBBBBBBBBBBBBBBBB
BBBBBBBBBBBBBBBBBBBBBBBBBBBBBBBBBBBBBBB
BBBBBBBBBBBBBBBBBBBBBBBBBBBBBBBBBBBBBBB
BBBBBBBBBBBBBBBBBBBBBBBBBBBBBBBBBBBBBBB
BBBBBBBBBBBBBBBBBBBBBBBBBBBBBBBBBBBBBBB
BBBBBBBBBBH                   BBBBBBBBB
BBBBBBBBBBBB   SS            EBBBBBBBBB
BBBBBBBBBB     BB          BBBBBBBBBBBB
BBBBBBBBBB         CH  B      BBBBBBBBB
BBBBBBBBBB        BBB         BBBBBBBBB
BBBBBBBBBBJJ  BB              BBBBBBBBB
BBBBBBBBBBBB     B           FBBBBBBBBB
BBBBBBBBBB         B        FFBBBBBBBBB
BBBBBBBBBB                  BBBBBBBBBBB
BBBBBBBBBB               B    BBBBBBBBB
BBBBBBBBBB            BB      BBBBBBBBB
BBBBBBBBBB          J         BBBBBBBBB
BBBBBBBBBB         BB         BBBBBBBBB
BBBBBBBBBB     P         SSSSSBBBBBBBBB
BBBBBBBBBBBBBBBBBBBBBBBBBBBBBBBBBBBBBBB
BBBBBBBBBBBBBBBBBBBBBBBBBBBBBBBBBBBBBBB
BBBBBBBBBBBBBBBBBBBBBBBBBBBBBBBBBBBBBBB
BBBBBBBBBBBBBBBBBBBBBBBBBBBBBBBBBBBBBBB
BBBBBBBBBBBBBBBBBBBBBBBBBBBBBBBBBBBBBBB